a -- bitta
abandon -- tark etmoq
ability -- qobiliyat
able -- qodir
abortion -- abort
about -- haqida
above -- yuqorida
abroad -- chet elda
absence -- yo’qligi
absolute -- mutlaq
absolutely -- mutlaqo
absorb -- singdirish
abuse -- suiiste’mol qilish
academic -- akademik
accept -- qabul qilish
access -- kirish
accident -- baxtsiz hodisa
accompany -- hamrohlik qilish
accomplish -- bajarish
according -- ko’ra
account -- hisob
accurate -- aniq
accuse -- ayblash
achieve -- erishish
achievement -- muvaffaqiyat
acid -- kislota
acknowledge -- tan olmoq
acquire -- egallash
across -- bo’ylab
act -- harakat
action -- harakat
active -- faol
activist -- faol
activity -- faoliyat
actor -- aktyor
actress -- aktrisa
actual -- haqiqiy
actually -- aslida
ad -- e’lon
adapt -- moslashish
add -- qo’shish
addition -- qo’shimcha
additional -- qo’shimcha
address -- manzil
adequate -- adekvat
adjust -- sozlash
adjustment -- moslashish
administration -- boshqaruv
administrator -- administrator
admire -- qoyil qolish
admission -- qabul qilish
admit -- tan olish
adolescent -- o’smir
adopt -- qabul qilish
adult -- kattalar
advance -- avans
advanced -- rivojlangan
advantage -- afzallik
adventure -- sarguzasht
advertising -- reklama
advice -- maslahat
advise -- maslahat bering
adviser -- maslahatchi
advocate -- himoyachi
affair -- ish
affect -- ta’sir qilish
afford -- imkoniyatiga ega
afraid -- qo’rqib
African -- afrikalik
African-American -- afro-amerikalik
after -- keyin
afternoon -- tushdan keyin
again -- yana
against -- qarshi
age -- yoshi
agency -- agentlik
agenda -- kun tartibi
agent -- agent
aggressive -- tajovuzkor
ago -- oldin
agree -- rozi
agreement -- kelishuv
agricultural -- qishloq xo’jaligi
ahead -- oldinda
aid -- yordam
aide -- yordamchi
AIDS -- OITS
aim -- maqsad
air -- havo
aircraft -- samolyot
airline -- aviakompaniya
airport -- aeroport
album -- albom
alcohol -- spirtli ichimliklar
alive -- tirik
all -- hammasi
alliance -- ittifoq
allow -- ruxsat berish
ally -- ittifoqdosh
almost -- deyarli
alone -- yolg’iz
along -- birga
already -- allaqachon
also -- shuningdek
alter -- o’zgartirish
alternative -- muqobil
although -- garchi
always -- har doim
am -- am
amazing -- ajoyib
American -- amerikalik
among -- orasida
amount -- miqdori
an -- a
analysis -- tahlil
analyst -- tahlilchi
analyze -- tahlil qilish
ancient -- qadimiy
and -- va
anger -- g’azab
angle -- burchak
angry -- badjahl
animal -- hayvon
anniversary -- yubiley
announce -- e’lon qilish
annual -- yillik
another -- boshqa
answer -- javob
anticipate -- bashorat qilish
anxiety -- tashvish
any -- har qanday
anybody -- hech kim
anymore -- endi
anyone -- har kim
anything -- har qanday narsa
anyway -- nima bo’lganda ham
anywhere -- har qanday joyda
apart -- alohida
apartment -- kvartira
apparent -- aniq
apparently -- aftidan
appeal -- Shikoyat qilish
appear -- paydo bo’ladi
appearance -- ko’rinish
apple -- olma
application -- ilova
apply -- murojaat qiling
appoint -- tayinlash
appointment -- tayinlash
appreciate -- qadrlash
approach -- yondashuv
appropriate -- muvofiq
approval -- tasdiqlash
approve -- ma’qullash
approximately -- taxminan
Arab -- arab
architect -- arxitektor
are -- bor
area -- hudud
argue -- bahslashmoq
argument -- dalil
arise -- paydo bo’ladi
arm -- qo’l
armed -- qurollangan
army -- armiya
around -- atrofida
arrange -- tartibga solish
arrangement -- tartibga solish
arrest -- hibsga olish
arrival -- kelishi
arrive -- yetib kelish
art -- san’at
article -- maqola
artist -- rassom
artistic -- badiiy
as -- kabi
Asian -- osiyolik
aside -- chetga
ask -- so’rang
asleep -- uyquda
aspect -- jihati
assault -- hujum
assert -- da’vo qilish
assess -- baho bering
assessment -- baholash
asset -- aktiv
assign -- tayinlash
assignment -- topshiriq
assist -- yordam berish
assistance -- yordam
assistant -- yordamchi
associate -- sherik
association -- uyushma
assume -- faraz qilmoq
assumption -- faraz
assure -- ishontirmoq
at -- da
athlete -- sportchi
athletic -- atletik
atmosphere -- atmosfera
atom -- atom
attach -- biriktir
attack -- hujum
attempt -- urinish
attend -- qatnashmoq
attention -- diqqat
attitude -- munosabat
attorney -- advokat
attract -- jalb qilish
attractive -- jozibali
attribute -- xususiyat
audience -- tomoshabinlar
author -- muallif
authority -- hokimiyat
auto -- avto
available -- mavjud
average -- o’rtacha
avoid -- qochish
award -- mukofoti
aware -- xabardor
awareness -- xabardorlik
away -- uzoqda
awful -- dahshatli
baby -- chaqaloq
back -- orqaga
background -- fon
bad -- yomon
badly -- yomon
bag -- sumka
bake -- pishirmoq
balance -- muvozanat
ball -- to’p
ban -- taqiqlash
band -- band
bank -- bank
bar -- bar
barely -- zo’rg’a
barrel -- bochka
barrier -- to’siq
base -- asos
baseball -- beysbol
basic -- Asosiy
basically -- asosan
basis -- asos
basket -- savat
basketball -- basketbol
bat -- yarasa
bathroom -- hammom
battery -- batareya
battle -- jang
be -- bo’l
beach -- plyaj
bean -- loviya
bear -- ayiq
beat -- urish
beautiful -- go’zal
beauty -- go’zallik
because -- chunki
become -- bo’lish
bed -- yotoq
bedroom -- yotoqxona
been -- bo’lgan
beer -- pivo
before -- oldin
began -- boshlangan
begin -- boshlash
beginning -- boshlanishi
behavior -- xulq-atvor
behind -- orqasida
being -- bo’lish
belief -- e’tiqod
believe -- ishon
bell -- qo’ng’iroq
belong -- tegishli
below -- quyida
belt -- kamar
bench -- skameyka
bend -- egilish
beneath -- ostida
benefit -- foyda
beside -- yonida
besides -- bundan tashqari
best -- eng yaxshi
bet -- tikish
better -- yaxshiroq
between -- orasida
beyond -- tashqari
Bible -- Injil
big -- katta
bike -- velosiped
bill -- hisob
billion -- milliard
bind -- bog’lamoq
biological -- biologik
bird -- qush
birth -- tug’ilish
birthday -- tug’ilgan kun
bit -- bit
bite -- tishlash
black -- qora
blade -- pichoq
blame -- ayblash
blanket -- adyol
blind -- ko’r
block -- blok
blood -- qon
blow -- puflamoq
blue -- ko’k
board -- taxta
boat -- qayiq
body -- tanasi
bomb -- bomba
bombing -- bombardimon qilish
bond -- rishta
bone -- suyak
book -- kitob
boom -- bum
boot -- yuklash
border -- chegara
born -- tug’ilgan
borrow -- qarz olish
boss -- xo’jayin
both -- ikkalasi ham
bother -- bezovta qilmoq
bottle -- shisha
bottom -- pastki
bought -- sotib oldi
boundary -- chegara
bowl -- kosa
box -- quti
boy -- yigit
boyfriend -- yigit
brain -- miya
branch -- filiali
brand -- brend
bread -- non
break -- tanaffus
breakfast -- nonushta
breast -- ko’krak
breath -- nafas
breathe -- nafas ol
brick -- g’isht
bridge -- ko’prik
brief -- qisqacha
briefly -- qisqacha
bright -- yorqin
brilliant -- ajoyib
bring -- olib keling
British -- Britaniya
broad -- keng
broke -- buzildi
broken -- buzilgan
brother -- uka
brought -- olib keldi
brown -- jigarrang
brush -- cho’tka
buck -- pul
budget -- byudjet
build -- qurmoq
building -- bino
bullet -- o’q
bunch -- to’da
burden -- yuk
burn -- kuyish
bury -- dafn qilmoq
bus -- avtobus
business -- biznes
busy -- band
but -- lekin
butter -- sariyog’
button -- tugmasi
buy -- sotib olish
buyer -- xaridor
by -- tomonidan
cabin -- kabina
cabinet -- kabinet
cable -- kabel
cake -- tort
calculate -- hisoblash
call -- qo’ng’iroq qiling
came -- keldi
camera -- kamera
camp -- lager
campaign -- kampaniya
campus -- kampus
can -- mumkin
Canadian -- kanadalik
cancer -- saraton
candidate -- nomzod
cap -- qopqoq
capability -- qobiliyat
capable -- qodir
capacity -- sig’im
capital -- poytaxt
captain -- kapitan
capture -- qo’lga olish
car -- mashina
carbon -- uglerod
card -- karta
care -- g’amxo’rlik
career -- martaba
careful -- ehtiyotkor
carefully -- ehtiyotkorlik bilan
carrier -- tashuvchi
carry -- olib yurish
case -- hol
cash -- naqd pul
cast -- quyma
cat -- mushuk
catch -- tutmoq
category -- kategoriya
Catholic -- katolik
caught -- ushlandi
cause -- sabab
ceiling -- shift
celebrate -- nishonlash
celebration -- bayram
celebrity -- mashhur
cell -- hujayra
cent -- sent
center -- markaz
central -- markaziy
century -- asr
CEO -- Bosh ijrochi direktor
ceremony -- marosim
certain -- aniq
certainly -- albatta
chain -- zanjir
chair -- stul
chairman -- rais
challenge -- qiyinchilik
chamber -- kamera
champion -- chempion
championship -- chempionat
chance -- imkoniyat
change -- o’zgartirish
changing -- o’zgaruvchan
channel -- kanal
chapter -- bob
character -- xarakter
characteristic -- xarakterli
characterize -- xarakterlash
charge -- zaryad
charity -- xayriya
chart -- diagramma
chase -- ketidan quvmoq
cheap -- arzon
check -- tekshirish
cheek -- yonoq
cheese -- pishloq
chef -- oshpaz
chemical -- kimyoviy
chest -- ko’krak qafasi
chick -- jo’ja
chicken -- tovuq
chief -- boshliq
child -- bola
childhood -- bolalik
children -- bolalar
Chinese -- Xitoy
chip -- chip
chocolate -- shokolad
choice -- tanlash
cholesterol -- xolesterin
choose -- tanlang
chord -- akkord
Christian -- xristian
Christmas -- Rojdestvo
church -- cherkov
cigarette -- sigaret
circle -- doira
circumstance -- vaziyat
cite -- iqtibos keltiring
citizen -- fuqaro
city -- shahar
civil -- fuqarolik
civilian -- fuqarolik
claim -- Talab
class -- sinf
classic -- klassik
classroom -- sinf xonasi
clean -- toza
clear -- aniq
clearly -- aniq
client -- mijoz
climate -- iqlim
climb -- ko’tarilish
clinic -- klinika
clinical -- klinik
clock -- soat
close -- yaqin
closely -- yaqindan
closer -- yaqinroq
clothe -- kiyinmoq
clothes -- kiyimlar
clothing -- kiyim
cloud -- bulut
club -- klub
clue -- maslahat
cluster -- klaster
coach -- murabbiy
coal -- ko’mir
coalition -- koalitsiya
coast -- qirg’oq
coat -- palto
code -- kod
coffee -- qahva
cognitive -- kognitiv
cold -- sovuq
collapse -- qulash
colleague -- hamkasb
collect -- yig’ish
collection -- yig’ish
collective -- kollektiv
college -- kollej
colonial -- mustamlakachi
colony -- koloniya
color -- rang
column -- ustun
combination -- kombinatsiya
combine -- aralashtirmoq
come -- kelib
comedy -- komediya
comfort -- qulaylik
comfortable -- qulay
command -- buyruq
commander -- qo’mondon
comment -- izoh
commercial -- tijorat
commission -- komissiya
commit -- topshirmoq
commitment -- majburiyat
committee -- qo’mita
common -- umumiy
communicate -- muloqot qilish
communication -- aloqa
community -- jamiyat
company -- kompaniya
compare -- solishtiring
comparison -- solishtirish
compete -- raqobat qilish
competition -- musobaqa
competitive -- raqobatbardosh
competitor -- raqobatchi
complain -- shikoyat qilish
complaint -- shikoyat
complete -- to’liq
completely -- batamom
complex -- murakkab
complicated -- murakkab
component -- komponent
compose -- tuzmoq
composition -- tarkibi
comprehensive -- keng qamrovli
computer -- kompyuter
concentrate -- konsentratsiyalash
concentration -- diqqat
concept -- tushuncha
concern -- tashvish
concerned -- tashvish
concert -- konsert
conclude -- xulosa qilish
conclusion -- xulosa
concrete -- beton
condition -- holat
conduct -- o’tkazish
conference -- konferensiya
confidence -- ishonch
confident -- o’ziga ishongan
confirm -- tasdiqlang
conflict -- ziddiyat
confront -- duch kelmoq
confusion -- chalkashlik
Congress -- Kongress
congressional -- kongressga tegishli
connect -- ulanmoq
connection -- ulanish
consciousness -- ong
consensus -- Kelishuv
consequence -- oqibat
conservative -- konservativ
consider -- ko’rib chiqing
considerable -- sezilarli
consideration -- hisobga olish
consist -- iborat
consistent -- izchil
consonant -- undosh
constant -- doimiy
constantly -- doimiy
constitute -- tashkil qiladi
constitutional -- konstitutsiyaviy
construct -- qurish
construction -- qurilish
consultant -- maslahatchi
consume -- iste’mol
consumer -- iste’molchi
consumption -- iste’mol
contact -- aloqa
contain -- o’z ichiga oladi
container -- idish
contemporary -- zamondosh
content -- mazmuni
contest -- musobaqa
context -- kontekst
continent -- qit’a
continue -- davom eting
continued -- davom etdi
contract -- shartnoma
contrast -- kontrast
contribute -- hissa qo’shish
contribution -- hissa
control -- boshqaruv
controversial -- bahsli
controversy -- munozara
convention -- konventsiya
conventional -- an’anaviy
conversation -- suhbat
convert -- aylantirish
conviction -- hukm
convince -- ishontirish
cook -- oshpaz
cookie -- cookie
cooking -- pishirish
cool -- salqin
cooperation -- hamkorlik
cop -- politsiya
cope -- engish
copy -- nusxa ko’chirish
core -- yadro
corn -- makkajo’xori
corner -- burchak
corporate -- korporativ
corporation -- korporatsiya
correct -- to’g’ri
correspondent -- muxbir
cost -- xarajat
cotton -- paxta
couch -- divan
could -- mumkin
council -- kengash
counselor -- maslahatchi
count -- hisoblash
counter -- hisoblagich
country -- mamlakat
county -- okrug
couple -- juft
courage -- jasorat
course -- kurs
court -- sud
cousin -- amakivachcha
cover -- qopqoq
coverage -- qamrov
cow -- sigir
crack -- yorilish
craft -- hunarmandchilik
crash -- halokat
crazy -- aqldan ozgan
cream -- krem
crease -- burma
create -- yaratmoq
creation -- yaratish
creative -- ijodiy
creature -- mavjudot
credit -- kredit
crew -- ekipaj
crime -- jinoyat
criminal -- jinoyatchi
crisis -- inqiroz
criteria -- mezonlar
critic -- tanqidchi
critical -- tanqidiy
criticism -- tanqid
criticize -- tanqid qilmoq
crop -- hosil
cross -- kesib o’tish
crowd -- to’da
crucial -- hal qiluvchi ahamiyatga ega
cry -- hayqiriq
cultural -- madaniy
culture -- madaniyat
cup -- chashka
curious -- qiziquvchan
current -- joriy
currently -- hozirgi paytda
curriculum -- o’quv dasturi
custom -- Custom
customer -- mijoz
cut -- kesish
cycle -- tsikl
dad -- dada
daily -- har kuni
damage -- zarar
dance -- raqsga tushish
danger -- Xavf
dangerous -- xavfli
dare -- jur’at
dark -- qorong’i
darkness -- zulmat
data -- ma’lumotlar
date -- sana
daughter -- qizim
day -- kun
dead -- o’lik
deal -- bitim
dealer -- dilerlik
dear -- azizim
death -- o’lim
debate -- muzokara
debt -- qarz
decade -- o’n yil
decide -- qaror
decimal -- kasr
decision -- qaror
deck -- pastki
declare -- DECLARE
decline -- pasayish
decrease -- pasayish
deep -- chuqur
deeply -- chuqur
deer -- kiyik
defeat -- mag’lubiyat
defend -- himoya qilish
defendant -- himoyachi
defense -- mudofaa
defensive -- mudofaa
deficit -- kamomad
define -- aniqlash
definitely -- albatta
definition -- ta’rifi
degree -- gradus
delay -- kechikish
deliver -- yetkazib berish
delivery -- yetkazib berish
demand -- talab
democracy -- demokratiya
Democrat -- demokrat
democratic -- demokratik
demonstrate -- namoyish
demonstration -- namoyish
deny -- rad etish
department -- Bo’lim
depend -- bog’liq
dependent -- qaram
depending -- qarab
depict -- tasvirlash
depression -- depressiya
depth -- chuqurlik
deputy -- o’rinbosari
derive -- hosil qilish
describe -- tasvirlab bering
description -- tavsifi
desert -- cho’l
deserve -- loyiq
design -- dizayn
designer -- dizayner
desire -- istak
desk -- stol
desperate -- umidsiz
despite -- qaramay
destroy -- yo’q qilish
destruction -- halokat
detail -- batafsil
detailed -- batafsil
detect -- aniqlash
determine -- aniqlash
develop -- rivojlantirish
developing -- rivojlanmoqda
development -- rivojlantirish
device -- qurilma
devote -- bag’ishlash
dialogue -- dialog
dictionary -- lug’at
did -- qildi
die -- o’lish
diet -- parhez
differ -- farq qiladi
difference -- farq
different -- boshqacha
differently -- boshqacha
difficult -- qiyin
difficulty -- qiyinchilik
dig -- qazish
digital -- raqamli
dimension -- o’lchash
dining -- ovqatlanish
dinner -- kechki ovqat
direct -- bevosita
direction -- yo’nalishi
directly -- bevosita
director -- direktor
dirt -- axloqsizlik
dirty -- iflos
disability -- nogironlik
disagree -- rozi emas
disappear -- yo’qoladi
disaster -- falokat
discipline -- intizom
discourse -- nutq
discover -- kashf qilish
discovery -- kashfiyot
discrimination -- diskriminatsiya
discuss -- muhokama qilish
discussion -- munozara
disease -- kasallik
dish -- taom
dismiss -- ishdan bo’shatish
disorder -- tartibsizlik
display -- ko’rsatish
dispute -- bahs
distance -- masofa
distant -- uzoq
distinct -- alohida
distinction -- farqlash
distinguish -- farqlash
distribute -- tarqatish
distribution -- tarqatish
district -- tuman
diverse -- xilma-xil
diversity -- xilma-xilligi
divide -- bo’lmoq
division -- bo’linish
divorce -- ajralish
DNA -- DNK
do -- qilish
doctor -- shifokor
document -- hujjat
does -- qilsa
dog -- it
dollar -- dollar
domestic -- maishiy
dominant -- hukmron
dominate -- hukmronlik qiladi
don’t -- yo’q
done -- qilingan
door -- eshik
double -- ikki hissa
doubt -- shubha
down -- pastga
downtown -- shahar markazida
dozen -- o’nlab
draft -- qoralama
drag -- sudramoq
drama -- drama
dramatic -- dramatik
dramatically -- keskin
draw -- chizish
drawing -- chizish
dream -- orzu
dress -- kiyinish
drink -- ichish
drive -- haydash
driver -- haydovchi
drop -- tushirish
drug -- dori
dry -- quruq
duck -- o’rdak
due -- muddati
during -- davomida
dust -- chang
duty -- burch
each -- har bir
eager -- ishtiyoqli
ear -- quloq
early -- barvaqt
earn -- ishlab topmoq
earnings -- daromad
earth -- yer
ease -- sukunat
easily -- osongina
east -- sharq
eastern -- sharqiy
easy -- oson
eat -- yemoq
economic -- iqtisodiy
economics -- Iqtisodiyot
economist -- iqtisodchi
economy -- iqtisodiyot
edge -- chet
edition -- nashr
editor -- muharrir
educate -- tarbiyalash
education -- ta’lim
educational -- tarbiyaviy
educator -- o’qituvchi
effect -- ta’sir
effective -- samarali
effectively -- samarali
efficiency -- samaradorlik
efficient -- samarali
effort -- harakat qilish
egg -- tuxum
eight -- sakkiz
either -- yoki
elderly -- keksa
elect -- saylash
election -- saylov
electric -- elektr
electricity -- elektr energiyasi
electronic -- elektron
element -- element
elementary -- boshlang’ich
eliminate -- yo’q qilish
elite -- elita
else -- boshqa
elsewhere -- boshqa joyda
e-mail -- elektron pochta
embrace -- quchoqlash
emerge -- paydo bo’ladi
emergency -- favqulodda
emission -- emissiya
emotion -- hissiyot
emotional -- hissiy
emphasis -- ta’kidlash
emphasize -- ta’kidlash
employ -- ishga
employee -- xodim
employer -- ish beruvchi
employment -- bandlik
empty -- bo’sh
enable -- yoqish
encounter -- uchrashish
encourage -- rag’batlantirish
end -- oxiri
enemy -- dushman
energy -- energiya
enforcement -- ijro etish
engage -- shug’ullanish
engine -- dvigatel
engineer -- muhandis
engineering -- muhandislik
English -- Ingliz
enhance -- oshirish
enjoy -- rohatlaning
enormous -- ulkan
enough -- yetarli
ensure -- ta’minlash
enter -- kiriting
enterprise -- korxona
entertainment -- o’yin-kulgi
entire -- butun
entirely -- butunlay
entrance -- Kirish
entry -- kirish
environment -- muhit
environmental -- ekologik
episode -- epizod
equal -- teng
equally -- teng
equate -- tenglashtirmoq
equipment -- uskunalar
era -- davr
error -- xato
escape -- qochish
especially -- ayniqsa
essay -- insho
essential -- muhim
essentially -- asosan
establish -- o’rnatish
establishment -- tashkil etish
estate -- mulk
estimate -- taxmin qilish
etc -- va boshqalar
ethics -- axloq
ethnic -- etnik
European -- yevropalik
evaluate -- baho bering
evaluation -- baholash
even -- hatto
evening -- oqshom
event -- voqea
eventually -- oxir-oqibat
ever -- har doim
every -- har
everybody -- hamma
everyday -- har kuni
everyone -- hamma
everything -- hamma narsa
everywhere -- hamma joyda
evidence -- dalil
evolution -- evolyutsiya
evolve -- rivojlanadi
exact -- aniq
exactly -- aynan
examination -- imtihon
examine -- Imtihon
example -- misol
exceed -- oshib ketish
excellent -- ajoyib
except -- bundan mustasno
exception -- istisno
exchange -- almashish
excite -- hayajonlantirish
exciting -- hayajonli
executive -- ijrochi
exercise -- mashq qilish
exhibit -- ko’rgazma
exhibition -- ko’rgazma
exist -- mavjud
existence -- mavjudlik
existing -- mavjud
expand -- kengaytirish
expansion -- kengaytirish
expect -- kutish
expectation -- kutish
expense -- xarajat
expensive -- qimmat
experience -- tajriba
experiment -- tajriba
expert -- mutaxassis
explain -- tushuntiring
explanation -- tushuntirish
explode -- portlash
explore -- kashf qiling
explosion -- portlash
expose -- fosh qilish
exposure -- chalinish xavfi
express -- ifodalash
expression -- ifoda
extend -- uzaytirish
extension -- kengaytma
extensive -- keng qamrovli
extent -- darajada
external -- tashqi
extra -- qo’shimcha
extraordinary -- favqulodda
extreme -- ekstremal
extremely -- nihoyatda
eye -- ko’z
fabric -- mato
face -- yuz
facility -- qulaylik
fact -- haqiqat
factor -- omil
factory -- zavod
faculty -- fakultet
fade -- so’nish
fail -- muvaffaqiyatsiz
failure -- muvaffaqiyatsizlik
fair -- adolatli
fairly -- odilona
faith -- imon
fall -- tushish
familiar -- tanish
family -- oila
famous -- mashhur
fan -- muxlis
fantasy -- fantaziya
far -- uzoq
farm -- ferma
farmer -- dehqon
fashion -- moda
fast -- tez
fat -- semiz
fate -- taqdir
father -- ota
fault -- ayb
favor -- yaxshilik
favorite -- sevimli
fear -- qo’rquv
feature -- xususiyat
federal -- federal
fee -- haq
feed -- ozuqa
feel -- his qilish
feeling -- tuyg’u
feet -- oyoq
fell -- tushdi
fellow -- o’rtoq
felt -- his qildi
female -- ayol
fence -- panjara
few -- oz
fewer -- kamroq
fiber -- tola
fiction -- fantastika
field -- maydon
fifteen -- o’n besh
fifth -- beshinchi
fifty -- ellik
fig -- Anjir
fight -- kurash
fighter -- jangchi
fighting -- jang qilish
figure -- raqam
file -- fayl
fill -- to’ldirish
film -- film
final -- final
finally -- nihoyat
finance -- Moliya
financial -- moliyaviy
find -- toping
finding -- topish
fine -- yaxshi
finger -- barmoq
finish -- tugatish
fire -- olov
firm -- mustahkam
first -- birinchi
fish -- baliq
fishing -- baliq ovlash
fit -- mos
fitness -- fitnes
five -- besh
fix -- tuzatish
flag -- bayroq
flame -- olov
flat -- tekis
flavor -- lazzat
flee -- qochmoq
flesh -- go’sht
flight -- parvoz
float -- suzmoq
floor -- qavat
flow -- oqim
flower -- gul
fly -- pashsha
focus -- diqqat
folk -- xalq
follow -- ergash
following -- quyidagi
food -- ovqat
foot -- oyoq
football -- futbol
for -- uchun
force -- kuch
foreign -- xorijiy
forest -- o’rmon
forever -- abadiy
forget -- unut
form -- shakl
formal -- rasmiy
formation -- shakllanishi
former -- oldingi
formula -- formula
forth -- oldinga
fortune -- boylik
forward -- oldinga
found -- topildi
foundation -- asos
founder -- asoschisi
four -- to’rtta
fourth -- to’rtinchi
fraction -- kasr
frame -- ramka
framework -- ramka
free -- ozod
freedom -- erkinlik
freeze -- muzlash
French -- frantsuz
frequency -- chastota
frequent -- tez-tez
frequently -- tez-tez
fresh -- yangi
friend -- do’st
friendly -- do’stona
friendship -- do’stlik
from -- dan
front -- old
fruit -- meva
frustration -- umidsizlik
fuel -- yoqilg’i
full -- to’la
fully -- to’liq
fun -- qiziqarli
function -- funktsiyasi
fund -- fond
fundamental -- asosiy
funding -- moliyalashtirish
funeral -- dafn marosimi
funny -- kulgili
furniture -- mebel
furthermore -- bundan tashqari
future -- kelajak
gain -- daromad
galaxy -- galaktika
gallery -- galereya
game -- o’yin
gang -- to’da
gap -- bo’shliq
garage -- garaj
garden -- bog’
garlic -- sarimsoq
gas -- gaz
gate -- Darvoza
gather -- yig’ish
gave -- berdi
gay -- gey
gaze -- qarash
gear -- tishli
gender -- jins
gene -- gen
general -- umumiy
generally -- umuman
generate -- hosil qilish
generation -- avlod
genetic -- genetik
gentle -- muloyim
gentleman -- janob
gently -- muloyimlik bilan
German -- nemis
gesture -- imo-ishora
get -- olish
ghost -- sharpa
giant -- gigant
gift -- sovg’a
gifted -- iqtidorli
girl -- qiz
girlfriend -- qiz do’sti
give -- berish
given -- berilgan
glad -- xursand
glance -- qarash
glass -- stakan
global -- global
glove -- qo’lqop
go -- ket
goal -- maqsad
God -- Xudo
gold -- oltin
golden -- oltin
golf -- golf
gone -- ketdi
good -- yaxshi
got -- oldi
govern -- boshqarmoq
government -- hukumat
governor -- gubernator
grab -- tutmoq
grade -- daraja
gradually -- asta-sekin
graduate -- bitiruvchi
grain -- don
grand -- katta
grandfather -- bobo
grandmother -- buvi
grant -- grant
grass -- o’t
grave -- qabr
gray -- kulrang
great -- ajoyib
greatest -- eng buyuk
green -- yashil
grew -- o’sdi
grocery -- oziq-ovqat
ground -- zamin
group -- guruh
grow -- o’sadi
growing -- o’sib borayotgan
growth -- o’sish
guarantee -- kafolat
guard -- qo’riqchi
guess -- taxmin qiling
guest -- mehmon
guide -- hidoyat
guideline -- ko’rsatma
guilty -- aybdor
gun -- qurol
guy -- yigit
habit -- odat
habitat -- yashash joyi
had -- bor edi
hair -- Soch
half -- yarmi
hall -- zal
hand -- qo’l
handful -- hovuch
handle -- tutqich
hang -- osmoq
happen -- sodir bo’lmoq
happy -- baxtli
hard -- qiyin
hardly -- zo’rg’a
has -- ega
hat -- shlyapa
hate -- nafrat
have -- bor
he -- u
head -- bosh
headline -- sarlavha
headquarters -- shtab-kvartirasi
health -- salomatlik
healthy -- sog’lom
hear -- eshitish
heard -- eshitildi
hearing -- eshitish
heart -- yurak
heat -- issiqlik
heaven -- jannat
heavily -- og’ir
heavy -- og’ir
heel -- tovon
height -- balandligi
held -- o’tkazildi
helicopter -- vertolyot
hell -- jahannam
hello -- Salom
help -- Yordam
helpful -- foydali
her -- uni
here -- Bu yerga
heritage -- meros
hero -- qahramon
herself -- o’zi
hey -- Hey
hi -- salom
hide -- yashirmoq
high -- yuqori
highlight -- ta’kidlash
highly -- juda
highway -- avtomagistral
hill -- tepalik
him -- uni
himself -- o’zi
hip -- kestirib
hire -- yollash
his -- uning
historian -- tarixchi
historic -- tarixiy
historical -- tarixiy
history -- tarix
hit -- urish